15 17
*****************
*               *
* ****** ****** *
* *    * *    * *
*O **           *
* *    * *    * *
* ************* *
**              *
* ****** ****** *
* *    * *  * ***
*             * *
* *    * *    * *
* ************* *
*               *
*****************
P 13 1


